11111111111111111111
10000000000000000001
10001000000000000001
11111000000000000001
10000000000000000001
10000000000000000001
10000000000000000001
10000000111111110001
10000000000000000001
10000000000000000001
10011111111100000001
10011111111100000001
10000000000000000001
10000000000000000001
10000000111111111001
10000000000000000001
10000000000000000001
10000000000000000001
10000000000000000001
11111111111111111111