1111111111111111111111111111111111111111
1000000000000000000000000011000000000001
1000000000000000000000000011000000000001
1111111111111111100000000011001111111111
1111111111111111100000000011001111111111
1000000000000000000000000011000000000001
1000000000000000000000000011000000000001
1111111111111111111111110000000000000001
1111111111111111111111110000000000000001
1000000000000000000000000000000000000001
1000000000000000000000001111000000000001
1000000000000000000000011111100000000001
1111111110000000000000111111110000000001
1111111110000000000001111111111000000001
1000000110000000000001111111111000000001
1000000110000000000001111111111000000001
1000000000000000000000111111110000000001
1000000110000000000000011111100000000001
1000000110000000000000001111000000000001
1111111110000000000000000000000000000001
1000000110000000000000000000000011111111
1000000110000000000000000000000011111111
1000000000001100110011001100000011111111
1000000110001100110011001100000011111111
1000000110001111111111111100000011111111
1111111110001111111111111100000011111111
1000000110001111111001111100000011111111
1000000110001111111001111100000011111111
1000000000001111111001111100000011111111
1000000110000000000001111100000000000001
1111111110001111111111111100000000000001
1111111110000000000000000000000000000001
1000000000000000000000000000000000000001
1111111111111111100111111111111111111111
1000000000000000000000000000000000000001
1111111111111111100111111111111111111111
1000000000000000000000000000000000000001
1111111111111111100111111111111111111111
1000000000000000000000000000000000000001
1111111111111111111111111111111111111111